"filename", "language", "Dart", "comment", "blank", "total"
"c:\Users\Daniel\Desktop\Flutter_Practice\dara\dara_app\lib\main.dart", "Dart", 2, 1, 1, 4
"c:\Users\Daniel\Desktop\Flutter_Practice\dara\dara_app\lib\view\pages\accountant\accountant_home.dart", "Dart", 10, 0, 0, 10
"c:\Users\Daniel\Desktop\Flutter_Practice\dara\dara_app\lib\view\pages\accountant\income.dart", "Dart", 11, 0, -1, 10
"c:\Users\Daniel\Desktop\Flutter_Practice\dara\dara_app\lib\view\pages\accountant\income_dialog.dart", "Dart", 46, 0, 3, 49
"c:\Users\Daniel\Desktop\Flutter_Practice\dara\dara_app\lib\view\pages\accountant\stateful_dialog.dart", "Dart", 346, 0, 9, 355
"c:\Users\Daniel\Desktop\Flutter_Practice\dara\dara_app\lib\view\pages\admin\manage\reports\reports.dart", "Dart", 11, 4, 0, 15
"c:\Users\Daniel\Desktop\Flutter_Practice\dara\dara_app\lib\view\pages\admin\manage\user_list\SortFilterDrawer.dart", "Dart", 424, 2, 14, 440
"c:\Users\Daniel\Desktop\Flutter_Practice\dara\dara_app\lib\view\pages\admin\manage\user_list\user_info.dart", "Dart", 0, 0, 1, 1
"c:\Users\Daniel\Desktop\Flutter_Practice\dara\dara_app\lib\view\pages\admin\manage\user_list\user_list.dart", "Dart", 365, 3, 13, 381
"c:\Users\Daniel\Desktop\Flutter_Practice\dara\dara_app\lib\view\shared\colors.dart", "Dart", 4, 1, 1, 6
"c:\Users\Daniel\Desktop\Flutter_Practice\dara\dara_app\lib\view\shared\strings.dart", "Dart", 50, 2, 2, 54
"Total", "-", 1269, 13, 43, 1325