"filename", "language", "Dart", "comment", "blank", "total"
"c:\Users\Daniel\Desktop\Flutter_Practice\dara\dara_app\lib\controller\account\register_controller.dart", "Dart", 8, 0, 1, 9
"c:\Users\Daniel\Desktop\Flutter_Practice\dara\dara_app\lib\controller\providers\register_provider.dart", "Dart", 39, 2, 5, 46
"c:\Users\Daniel\Desktop\Flutter_Practice\dara\dara_app\lib\firebase_options.dart", "Dart", 53, 12, 4, 69
"c:\Users\Daniel\Desktop\Flutter_Practice\dara\dara_app\lib\main.dart", "Dart", 9, 0, 0, 9
"c:\Users\Daniel\Desktop\Flutter_Practice\dara\dara_app\lib\services\firebase\auth.dart", "Dart", 31, 6, 6, 43
"c:\Users\Daniel\Desktop\Flutter_Practice\dara\dara_app\lib\view\pages\account\login\login.dart", "Dart", 15, 0, 0, 15
"c:\Users\Daniel\Desktop\Flutter_Practice\dara\dara_app\lib\view\pages\account\register\register.dart", "Dart", 34, 0, 2, 36
"c:\Users\Daniel\Desktop\Flutter_Practice\dara\dara_app\lib\view\pages\account\register\register_email_pass.dart", "Dart", 36, 3, 0, 39
"c:\Users\Daniel\Desktop\Flutter_Practice\dara\dara_app\lib\view\pages\account\register\widgets\terms_and_conditions.dart", "Dart", 27, 14, 0, 41
"c:\Users\Daniel\Desktop\Flutter_Practice\dara\dara_app\lib\view\shared\components.dart", "Dart", 26, -6, 0, 20
"c:\Users\Daniel\Desktop\Flutter_Practice\dara\dara_app\lib\view\shared\strings.dart", "Dart", 8, 0, 0, 8
"Total", "-", 286, 31, 18, 335