"filename", "language", "Dart", "comment", "blank", "total"
"c:\Users\Daniel\Desktop\Flutter_Practice\dara\dara_app\lib\main.dart", "Dart", 6, 1, 1, 8
"c:\Users\Daniel\Desktop\Flutter_Practice\dara\dara_app\lib\view\pages\account\login\login.dart", "Dart", 170, 7, 4, 181
"c:\Users\Daniel\Desktop\Flutter_Practice\dara\dara_app\lib\view\pages\admin\home\main_home.dart", "Dart", 83, 5, 2, 90
"c:\Users\Daniel\Desktop\Flutter_Practice\dara\dara_app\lib\view\pages\admin\home_top_option\top_report.dart", "Dart", 417, 8, 20, 445
"c:\Users\Daniel\Desktop\Flutter_Practice\dara\dara_app\lib\view\pages\admin\profile\profile.dart", "Dart", 3, 0, 0, 3
"c:\Users\Daniel\Desktop\Flutter_Practice\dara\dara_app\lib\view\pages\admin\rent_process\documents\submission_guide.dart", "Dart", -13, 0, -3, -16
"c:\Users\Daniel\Desktop\Flutter_Practice\dara\dara_app\lib\view\pages\admin\rent_process\documents\submit_documents.dart", "Dart", 193, 1, 7, 201
"c:\Users\Daniel\Desktop\Flutter_Practice\dara\dara_app\lib\view\pages\admin\rent_process\documents\verify_booking.dart", "Dart", 71, 1, 4, 76
"c:\Users\Daniel\Desktop\Flutter_Practice\dara\dara_app\lib\view\pages\admin\rentals\rentals.dart", "Dart", 3, 1, 10, 14
"c:\Users\Daniel\Desktop\Flutter_Practice\dara\dara_app\lib\view\shared\strings.dart", "Dart", 30, 2, 1, 33
"Total", "-", 963, 26, 46, 1035