"filename", "language", "Dart", "comment", "blank", "total"
"c:\Users\Daniel\Desktop\Flutter_Practice\dara\dara_app\lib\controller\account\login_controller.dart", "Dart", 47, 20, 4, 71
"c:\Users\Daniel\Desktop\Flutter_Practice\dara\dara_app\lib\controller\account\register_controller.dart", "Dart", 131, 7, 10, 148
"c:\Users\Daniel\Desktop\Flutter_Practice\dara\dara_app\lib\controller\home\home_controller.dart", "Dart", 234, 11, 20, 265
"c:\Users\Daniel\Desktop\Flutter_Practice\dara\dara_app\lib\controller\providers\register_provider.dart", "Dart", 42, 3, 6, 51
"c:\Users\Daniel\Desktop\Flutter_Practice\dara\dara_app\lib\controller\rent_process\rent_process.dart", "Dart", 143, 3, 13, 159
"c:\Users\Daniel\Desktop\Flutter_Practice\dara\dara_app\lib\controller\singleton\persistent_data.dart", "Dart", 24, 8, 13, 45
"c:\Users\Daniel\Desktop\Flutter_Practice\dara\dara_app\lib\controller\utils\constants.dart", "Dart", 5, 0, 0, 5
"c:\Users\Daniel\Desktop\Flutter_Practice\dara\dara_app\lib\controller\utils\intent_utils.dart", "Dart", 31, 2, 5, 38
"c:\Users\Daniel\Desktop\Flutter_Practice\dara\dara_app\lib\firebase_options.dart", "Dart", 53, 12, 4, 69
"c:\Users\Daniel\Desktop\Flutter_Practice\dara\dara_app\lib\main.dart", "Dart", 124, 17, 22, 163
"c:\Users\Daniel\Desktop\Flutter_Practice\dara\dara_app\lib\model\account\register_model.dart", "Dart", 28, 0, 2, 30
"c:\Users\Daniel\Desktop\Flutter_Practice\dara\dara_app\lib\model\constants\firebase_constants.dart", "Dart", 3, 0, 0, 3
"c:\Users\Daniel\Desktop\Flutter_Practice\dara\dara_app\lib\services\firebase\auth.dart", "Dart", 64, 6, 8, 78
"c:\Users\Daniel\Desktop\Flutter_Practice\dara\dara_app\lib\services\firebase\firestore.dart", "Dart", 14, 0, 2, 16
"c:\Users\Daniel\Desktop\Flutter_Practice\dara\dara_app\lib\services\gcash\gcash_payment.dart", "Dart", 57, 2, 5, 64
"c:\Users\Daniel\Desktop\Flutter_Practice\dara\dara_app\lib\services\google\google.dart", "Dart", 21, 0, 5, 26
"c:\Users\Daniel\Desktop\Flutter_Practice\dara\dara_app\lib\services\weather\open_weather.dart", "Dart", 39, 8, 8, 55
"c:\Users\Daniel\Desktop\Flutter_Practice\dara\dara_app\lib\view\pages\account\account_opening.dart", "Dart", 73, 7, 8, 88
"c:\Users\Daniel\Desktop\Flutter_Practice\dara\dara_app\lib\view\pages\account\login\login.dart", "Dart", 400, 24, 22, 446
"c:\Users\Daniel\Desktop\Flutter_Practice\dara\dara_app\lib\view\pages\account\register\register.dart", "Dart", 352, 13, 21, 386
"c:\Users\Daniel\Desktop\Flutter_Practice\dara\dara_app\lib\view\pages\account\register\register_email_pass.dart", "Dart", 164, 12, 12, 188
"c:\Users\Daniel\Desktop\Flutter_Practice\dara\dara_app\lib\view\pages\account\register\register_phone_number.dart", "Dart", 155, 15, 14, 184
"c:\Users\Daniel\Desktop\Flutter_Practice\dara\dara_app\lib\view\pages\account\register\register_successful.dart", "Dart", 63, 5, 7, 75
"c:\Users\Daniel\Desktop\Flutter_Practice\dara\dara_app\lib\view\pages\account\register\register_verify_phone.dart", "Dart", 105, 8, 9, 122
"c:\Users\Daniel\Desktop\Flutter_Practice\dara\dara_app\lib\view\pages\account\register\widgets\terms_and_conditions.dart", "Dart", 346, 34, 36, 416
"c:\Users\Daniel\Desktop\Flutter_Practice\dara\dara_app\lib\view\pages\accountant\accountant_home.dart", "Dart", 48, 1, 4, 53
"c:\Users\Daniel\Desktop\Flutter_Practice\dara\dara_app\lib\view\pages\admin\car_list\car_list_.dart", "Dart", 720, 15, 24, 759
"c:\Users\Daniel\Desktop\Flutter_Practice\dara\dara_app\lib\view\pages\admin\car_list\unit_preview.dart", "Dart", 696, 28, 18, 742
"c:\Users\Daniel\Desktop\Flutter_Practice\dara\dara_app\lib\view\pages\admin\center_button\google_maps.dart", "Dart", 19, 0, 3, 22
"c:\Users\Daniel\Desktop\Flutter_Practice\dara\dara_app\lib\view\pages\admin\home\home_page.dart", "Dart", 160, 3, 10, 173
"c:\Users\Daniel\Desktop\Flutter_Practice\dara\dara_app\lib\view\pages\admin\home\main_home.dart", "Dart", 839, 18, 15, 872
"c:\Users\Daniel\Desktop\Flutter_Practice\dara\dara_app\lib\view\pages\admin\home_top_option\top_report.dart", "Dart", 419, 8, 20, 447
"c:\Users\Daniel\Desktop\Flutter_Practice\dara\dara_app\lib\view\pages\admin\manage\inquiries\inquiries.dart", "Dart", 528, 16, 23, 567
"c:\Users\Daniel\Desktop\Flutter_Practice\dara\dara_app\lib\view\pages\admin\manage\reports\reports.dart", "Dart", 1072, 29, 34, 1135
"c:\Users\Daniel\Desktop\Flutter_Practice\dara\dara_app\lib\view\pages\admin\manage\status\status.dart", "Dart", 764, 11, 10, 785
"c:\Users\Daniel\Desktop\Flutter_Practice\dara\dara_app\lib\view\pages\admin\profile\profile.dart", "Dart", 667, 28, 30, 725
"c:\Users\Daniel\Desktop\Flutter_Practice\dara\dara_app\lib\view\pages\admin\rent_process\booking_details.dart", "Dart", 424, 5, 21, 450
"c:\Users\Daniel\Desktop\Flutter_Practice\dara\dara_app\lib\view\pages\admin\rent_process\delivery_mode.dart", "Dart", 320, 6, 9, 335
"c:\Users\Daniel\Desktop\Flutter_Practice\dara\dara_app\lib\view\pages\admin\rent_process\details_fees.dart", "Dart", 315, 3, 12, 330
"c:\Users\Daniel\Desktop\Flutter_Practice\dara\dara_app\lib\view\pages\admin\rent_process\documents\submit_documents.dart", "Dart", 193, 1, 7, 201
"c:\Users\Daniel\Desktop\Flutter_Practice\dara\dara_app\lib\view\pages\admin\rent_process\documents\verify_booking.dart", "Dart", 71, 1, 4, 76
"c:\Users\Daniel\Desktop\Flutter_Practice\dara\dara_app\lib\view\pages\admin\rent_process\gcash_webview.dart", "Dart", 50, 0, 4, 54
"c:\Users\Daniel\Desktop\Flutter_Practice\dara\dara_app\lib\view\pages\admin\rent_process\payment_success.dart", "Dart", 239, 2, 7, 248
"c:\Users\Daniel\Desktop\Flutter_Practice\dara\dara_app\lib\view\pages\admin\rentals\rentals.dart", "Dart", 1325, 25, 40, 1390
"c:\Users\Daniel\Desktop\Flutter_Practice\dara\dara_app\lib\view\pages\admin\rentals\report.dart", "Dart", 428, 8, 20, 456
"c:\Users\Daniel\Desktop\Flutter_Practice\dara\dara_app\lib\view\pages\carousel\carousel_page.dart", "Dart", 12, 0, 3, 15
"c:\Users\Daniel\Desktop\Flutter_Practice\dara\dara_app\lib\view\pages\carousel\widgets\page_1.dart", "Dart", 118, 2, 5, 125
"c:\Users\Daniel\Desktop\Flutter_Practice\dara\dara_app\lib\view\pages\carousel\widgets\page_2.dart", "Dart", 154, 2, 5, 161
"c:\Users\Daniel\Desktop\Flutter_Practice\dara\dara_app\lib\view\pages\carousel\widgets\page_3.dart", "Dart", 154, 2, 5, 161
"c:\Users\Daniel\Desktop\Flutter_Practice\dara\dara_app\lib\view\pages\carousel\widgets\page_4.dart", "Dart", 154, 2, 5, 161
"c:\Users\Daniel\Desktop\Flutter_Practice\dara\dara_app\lib\view\pages\carousel\widgets\page_5.dart", "Dart", 154, 2, 5, 161
"c:\Users\Daniel\Desktop\Flutter_Practice\dara\dara_app\lib\view\pages\carousel\widgets\page_6.dart", "Dart", 154, 2, 5, 161
"c:\Users\Daniel\Desktop\Flutter_Practice\dara\dara_app\lib\view\pages\entry\entry_page_video.dart", "Dart", 49, 0, 10, 59
"c:\Users\Daniel\Desktop\Flutter_Practice\dara\dara_app\lib\view\shared\colors.dart", "Dart", 27, 3, 2, 32
"c:\Users\Daniel\Desktop\Flutter_Practice\dara\dara_app\lib\view\shared\components.dart", "Dart", 255, 4, 12, 271
"c:\Users\Daniel\Desktop\Flutter_Practice\dara\dara_app\lib\view\shared\info_dialog.dart", "Dart", 74, 3, 7, 84
"c:\Users\Daniel\Desktop\Flutter_Practice\dara\dara_app\lib\view\shared\loading.dart", "Dart", 91, 4, 7, 102
"c:\Users\Daniel\Desktop\Flutter_Practice\dara\dara_app\lib\view\shared\strings.dart", "Dart", 541, 36, 56, 633
"Total", "-", 13952, 487, 698, 15137