"filename", "language", "Dart", "comment", "blank", "total"
"c:\Users\Daniel\Desktop\Flutter_Practice\dara\dara_app\lib\controller\account\login_controller.dart", "Dart", 50, 0, 3, 53
"c:\Users\Daniel\Desktop\Flutter_Practice\dara\dara_app\lib\controller\account\register_controller.dart", "Dart", 61, 4, 6, 71
"c:\Users\Daniel\Desktop\Flutter_Practice\dara\dara_app\lib\controller\singleton\persistent_data.dart", "Dart", 1, 1, 1, 3
"c:\Users\Daniel\Desktop\Flutter_Practice\dara\dara_app\lib\main.dart", "Dart", 2, 1, 1, 4
"c:\Users\Daniel\Desktop\Flutter_Practice\dara\dara_app\lib\model\account\register_model.dart", "Dart", 28, 0, 2, 30
"c:\Users\Daniel\Desktop\Flutter_Practice\dara\dara_app\lib\model\constants\firebase_constants.dart", "Dart", 3, 0, 0, 3
"c:\Users\Daniel\Desktop\Flutter_Practice\dara\dara_app\lib\services\firebase\firestore.dart", "Dart", 14, 0, 2, 16
"c:\Users\Daniel\Desktop\Flutter_Practice\dara\dara_app\lib\services\google\google.dart", "Dart", 21, 0, 5, 26
"c:\Users\Daniel\Desktop\Flutter_Practice\dara\dara_app\lib\view\pages\account\login\login.dart", "Dart", 28, 4, 2, 34
"c:\Users\Daniel\Desktop\Flutter_Practice\dara\dara_app\lib\view\pages\account\register\register_phone_number.dart", "Dart", 28, 3, 0, 31
"c:\Users\Daniel\Desktop\Flutter_Practice\dara\dara_app\lib\view\pages\account\register\widgets\terms_and_conditions.dart", "Dart", 2, -11, 0, -9
"c:\Users\Daniel\Desktop\Flutter_Practice\dara\dara_app\lib\view\pages\home\home_page.dart", "Dart", 44, 2, 4, 50
"c:\Users\Daniel\Desktop\Flutter_Practice\dara\dara_app\lib\view\shared\components.dart", "Dart", 13, -8, 3, 8
"c:\Users\Daniel\Desktop\Flutter_Practice\dara\dara_app\lib\view\shared\strings.dart", "Dart", 3, 0, 0, 3
"Total", "-", 298, -4, 29, 323